10.ox
co......o.
.o........
......o.o.
.....o..oo
....o.....
o.........
..o.o.....
oo........
.....o.o..
..o.o.o...
