10.ox
o....o.o.o
oo.oo.o...
.....ooo.o
o....o...o
.o........
.o..o....o
o..o....o.
...ooo....
oo.o...o..
..o..o...o
